20 20 20 20 20 20 20 20 20 20 20 20 20 20 20 20 20 20 20 20 20 20 20 20 20 20 20 20 20 20 20 20
20 0 0 0 0 0 0 0 0 0 0 0 0 0 2 2 2 2 2 2 2 2 0 0 0 0 0 0 0 0 0 20
20 0 14 15 15 15 14 0 0 0 0 0 2 3 3 3 2 2 2 2 14 15 15 15 14 15 15 15 14 0 0 20
20 0 14 7 7 7 15 15 15 15 15 14 2 3 3 3 3 3 2 2 14 7 7 7 14 7 7 7 14 0 0 20
20 0 14 7 7 7 0 7 7 7 7 14 2 2 3 3 3 3 3 2 14 7 7 7 14 7 7 7 15 14 0 20
20 0 15 15 0 15 14 7 7 7 7 14 0 2 2 2 3 3 2 2 14 7 7 7 0 7 7 7 7 14 0 20
20 0 0 0 1 0 14 7 7 7 7 14 0 0 2 2 1 2 2 0 14 7 7 7 14 7 7 7 7 14 0 20
20 0 0 0 1 0 15 15 15 15 15 15 0 0 0 2 1 0 0 0 15 15 14 15 15 15 14 7 7 14 0 20
20 0 0 0 1 1 1 1 1 1 1 1 1 1 1 1 1 0 0 0 0 0 14 7 7 7 14 7 7 14 0 20
20 0 14 15 15 14 0 0 1 0 0 0 0 0 0 0 1 0 0 0 0 0 15 7 7 7 0 7 7 14 0 20
20 0 14 7 7 15 0 0 1 0 14 15 15 15 14 0 1 1 1 1 1 1 0 7 7 7 14 15 15 15 0 20
20 0 14 7 7 0 1 1 1 1 14 7 7 7 14 0 1 0 0 0 0 0 14 7 7 7 14 0 0 0 0 20
20 0 14 7 7 15 15 14 0 1 14 7 7 7 14 0 1 0 0 0 0 0 14 7 7 7 14 0 0 0 0 20
20 0 14 7 7 7 7 14 0 1 15 15 0 15 15 0 1 0 0 0 0 0 14 7 7 7 14 0 0 0 0 20
20 0 15 15 15 15 15 15 0 1 0 0 1 0 0 0 1 0 0 0 0 0 15 15 15 15 15 0 0 0 0 20
20 2 2 2 2 2 0 0 0 1 1 1 1 1 1 1 1 0 0 0 0 0 0 0 0 0 0 0 0 0 0 20
20 2 3 3 3 2 2 2 0 0 0 0 0 0 0 1 0 0 0 0 0 0 0 0 0 0 0 0 0 0 0 20
20 3 3 3 3 3 2 2 2 0 0 0 0 0 2 1 0 0 0 0 0 0 0 0 0 0 0 0 0 0 0 20
20 3 3 3 3 3 3 1 1 1 1 0 2 2 2 1 2 2 0 0 0 0 0 0 0 0 0 0 0 0 0 20
20 3 3 3 3 3 3 2 2 2 1 2 2 2 2 1 2 2 2 0 0 0 0 0 0 0 0 0 0 0 0 20
20 3 3 3 3 3 2 2 2 2 1 2 2 2 2 1 2 2 2 0 0 0 0 0 0 0 0 0 0 0 0 20
20 2 3 3 2 2 2 2 2 2 1 1 1 1 1 1 2 2 2 0 0 0 0 0 0 0 0 0 0 0 0 20
20 2 2 2 2 0 0 0 2 2 2 2 1 2 2 2 2 2 0 0 0 0 0 0 0 0 0 0 0 0 0 20
20 0 0 0 0 0 0 0 0 0 2 2 1 2 2 2 2 0 0 0 0 0 0 0 0 0 0 0 0 0 0 20
20 0 0 0 0 0 0 0 0 0 2 2 1 2 2 2 0 0 0 0 0 0 0 0 0 0 0 3 3 0 0 20
20 0 0 0 0 0 0 0 0 0 0 2 1 2 0 0 0 0 0 0 0 0 0 0 0 0 3 3 3 3 0 20
20 0 0 0 0 0 0 0 0 0 0 0 1 0 0 0 0 0 0 0 0 0 0 0 0 3 3 3 3 3 0 20
20 0 0 0 0 0 0 0 0 14 15 15 0 15 15 14 0 0 0 0 0 0 0 0 3 3 3 3 3 0 0 20
20 0 0 0 0 0 0 0 0 14 7 7 7 7 7 14 0 0 0 0 0 0 0 0 3 3 3 0 0 0 0 20
20 0 0 0 0 0 0 0 0 14 7 7 7 7 7 14 0 0 0 0 0 0 0 0 0 0 0 0 0 0 0 20
20 0 0 0 0 0 0 0 0 15 15 15 15 15 15 15 0 0 0 0 0 0 0 0 0 0 0 0 0 0 0 20
20 20 20 20 20 20 20 20 20 20 20 20 20 20 20 20 20 20 20 20 20 20 20 20 20 20 20 20 20 20 20 20
